11111111111
10000C00001
1000000P001
100E0000001
11111111111