111111111111111111111
100000000000000000001
100000000000000000001
100000000000000000001
1000P0000000000000001
100000000000000000001
100000000000000000001
100000000000000000001
10000000000000C000001
100000000000000000001
100000000000000000001
100000000000000000001
100000000000000000001
100000000000000000001
100000000000000000001
10000000000000E000001
111111111111111111111
