111111111111111111111
1000000000000000000P1
101111111111111111111
100000000000000000001
111111111111111111101
100000000000000000001
101111111111111111111
100000000000000000001
101111111111111111011
100000000000000000001
110001111111111111101
101000000000000000001
100100111111111111111
100010000001000100001
101010111111010100001
1C10000000P001E100001
111111111111111111111