11111111111111111111111111111111
11111111111111111111111111111111
11111111111111111111111111111111
11111111111111111111111111111111
11111111111111111111111111111111
11111111111111111111111111111111
11111111111111111111111111111111
11111111000111110000000000011111
11111111010111110111111111011111
11111111010111110100000000011111
11111111010111110101111111111111
11111111010111110101111111111111
11111111010111110101111111111111
11111111010111110101111111111111
11111111010111110101111111111111
11111111010000000100000000011111
11111111011111111111111111011111
11111111000000000100000001011111
11111111111111110101111101011111
11111111111111110101111101011111
11111111111111110101111101011111
11111111111111110101111101011111
11111111111111110101111101011111
11111111000000000101111101011111
11111111011111111101111101011111
11111111000000000001111100011111
11111111111111111111111111111111
11111111111111111111111111111111
11111111111111111111111111111111
11111111111111111111111111111111
11111111111111111111111111111111
11111111111111111111111111111111
